The Brick Awakens/14/14/$
ii1111111111ii
ib1112222111bi
11   ixxi   11
11  i1221i  11
11 ib1111bi 11
12i112  211i21
12x21    12x21
12x21    12x21
12i112  211i21
11 ib1111bi 11
11  i1221i  11
11   ixxi   11
ib1112222111bi
ii1111111111ii